PLATFORM
0 0 128 256
128 256 256 128
512 256 256 128
0 384 128 640
512 384 128 512
768 384 128 128
256 512 128 128
896 512 128 128
1024 640 128 128
256 768 128 128
1152 768 128 128
1408 896 256 128
128 1024 1280 128
1664 1024 128 128

TILES
15 9 128
6 0 0 0 0 0 0 0 0 0 0 0 0 0 0
6 0 0 0 0 0 0 0 0 0 0 0 0 0 0
2 2 2 0 4 5 0 0 0 0 0 0 0 0 0
6 0 0 0 4 0 5 0 0 0 0 0 0 0 0
6 0 2 0 4 0 0 5 0 0 0 0 0 0 0
6 0 0 0 4 0 0 0 5 0 0 0 0 0 0
6 0 2 0 4 0 0 0 0 5 0 0 0 0 0
6 0 0 0 0 0 0 0 0 0 0 5 5 0 0
6 2 2 2 2 2 2 2 2 2 2 2 2 2 0
