PLATFORM
0 0 6400 128
0 128 128 896
5760 128 256 256
2688 384 512 128
2560 512 128 128
3072 512 128 512
4352 512 512 128
5248 512 512 128
6272 512 128 128
384 640 512 128
1536 640 384 128
2304 640 256 128
3328 640 256 128
3712 640 256 128
4224 640 128 128
4736 640 128 384
5248 640 128 384
5632 640 128 384
6144 640 128 128
384 768 128 256
768 768 128 256
1408 768 128 256
1920 768 128 256
2304 768 128 256
4096 768 128 256
6016 768 128 256
128 896 256 128
512 896 256 128
896 896 512 128
1536 896 384 128
2048 896 256 128
2432 896 640 128
3200 896 896 128
4224 896 512 128
4864 896 384 128
5376 896 256 128
5760 896 256 128
6144 896 256 128

TILES
50 8 128
8 8 8 8 8 8 8 8 8 8 8 8 8 8 8 8 8 8 8 8 8 8 8 8 8 8 8 8 8 8 8 8 8 8 8 8 8 8 8 8 8 8 8 8 8 8 8 8 8 8
6 0 0 0 0 0 0 0 0 0 0 0 0 0 0 0 0 0 0 0 0 0 0 0 0 0 0 0 0 0 0 0 0 0 0 0 0 0 0 0 0 0 0 0 0 2 2 0 0 0
6 0 0 0 0 0 0 0 0 0 0 0 0 0 0 0 0 0 0 0 0 0 0 0 0 0 0 0 0 0 0 0 0 0 0 0 0 0 0 0 0 0 0 0 0 2 2 0 0 0
6 0 0 0 0 0 0 0 0 0 0 0 0 0 0 0 0 0 0 0 0 2 2 2 2 0 0 0 0 0 0 0 0 0 0 0 0 0 0 0 0 0 0 0 0 0 0 0 0 0
6 0 0 0 0 0 0 0 0 0 0 0 0 0 0 0 0 0 0 0 2 2 2 2 2 0 0 0 0 0 0 0 0 0 2 2 2 2 0 0 0 2 2 2 2 0 0 0 0 2
6 0 0 3 3 3 3 0 0 0 0 0 2 2 2 0 0 0 2 2 2 2 2 2 2 0 2 2 0 2 2 0 0 2 2 5 5 5 0 0 0 2 2 2 2 0 0 0 2 2
6 0 0 4 5 5 6 0 0 0 0 2 2 2 2 2 0 0 2 2 2 2 2 2 2 0 0 0 0 0 0 0 2 2 2 5 5 5 0 0 0 2 2 2 2 0 0 2 2 2
2 2 2 5 5 5 5 2 2 2 2 2 2 2 2 2 2 2 2 2 2 2 2 2 2 2 2 2 2 2 2 2 2 2 2 2 2 2 2 2 2 2 2 2 2 2 2 2 2 2
